#######################################
#.....................................#
#.....................................#
#.....................................#
#.....................................#
#.....................................#
#.....................................#
#.....................................#
#.....................................#
#.....................................#
#.....................................#
#.....................................#
#.....................................#
#.....................................#
#.....................................#
#......................#..............#
#......................#..............#
#......................#..............#
#......................#..............#
#..............#########..............#
#......................#..............#
#......................#..............#
#.........#####.......................#
#.....................................#
#.....................................#
#.....................................#
#.....................................#
#.....................................#
#.....................................#
#.....................................#
#.....................................#
#........#################............#
#.....................................#
#.....................................#
#.....................................#
#.....................................#
#.....................................#
#.....................................#
#.....................................#
######################################.