#######################################
#.....................................#
#.....................................#
#.....................................#
#.....................................#
#.....................................#
#.....................................#
#.....................................#
#.....................................#
#.....................................#
#.....................................#
#.....................................#
#.....................................#
#.....................................#
#.....................................#
#.....................................#
#.....................................#
#.....................................#
#.....................................#
#.....................................#
#.....................................#
#.....................................#
#.....................................#
#.....................................#
#.....................................#
#.....................................#
#.....................................#
#.....................................#
#.....................................#
#.....................................#
#.....................................#
#.....................................#
#.....................................#
#.....................................#
#.....................................#
#.....................................#
#.....................................#
#.....................................#
#.....................................#
######################################.