.......................................
.......................................
.......................................
...#...................................
...#...................................
...#...................................
...#...................................
...#################################...
...#...................................
...#...................................
...#...................................
...#...................................
.......................................
.......................................
.......................................
.......................................
.......................................
.......................................
.......................................
.......................................
.......................................
.......................................
.......................................
...#################################...
.......................................
.......................................
.......................................
.......................................
.......................................
.......................................
...#...................................
...#...................................
...#..............#....................
...#..............#....................
...#..............#....................
...#..............#....................
...#################################...
.......................................
.......................................
.......................................